............................................................................................................................
....................................................................................................└─┐.................................................................................................
......................................................................................................│.................................................................................................
......................................................................................................│.................................................................................................
.....................................................................................................┌┘.................................................................................................
.....................................................................................................│..................................................................................................
.....................................................................................................└─┐................................................................................................
....................................................................................................┌──┘................................................................................................
..................................................................................................┌─┘...................................................................................................
..................................................................................................└──┐..................................................................................................
.....................................................................................................│..................................................................................................
.....................................................................................................│..................................................................................................
.....................................................................................................│..................................................................................................
.....................................................................................................│..................................................................................................
.....................................................................................................│....┌┐............................................................................................
.....................................................................................................└────┘└┐...........................................................................................
.........................................................................................................┌──┘...........................................................................................
.........................................................................................................└──┐...........................................................................................
............................................................................................................│...........................................................................................
............................................................................................................│┌──┐......┌─┐..............................................................................
............................................................................................................└┘.┌┘....┌┬┴─┘┌─┐...........................................................................
...............................................................................................................└┐....│├┐.┌┴<│...........................................................................
...............................................................................................................┌┘....│││.│.┌┘...........................................................................
...............................................................................................................│.....├┤├┬┼─┘............................................................................
..............................................................................................................┌┘.....├┼┼┴┴┬─<........┌─┐................................................................
..............................................................................................................└─┐..┌┬┴┼┤..│.........┌┘.│................................................................
................................................................................................................└──┘├┬┘└┐.│.......┌┐└──┼┐........................┌─┐....................................
...............................................................................................................┌┐...│└┐.│.│..┌──┐.││.┌┐├┼┐......................┌┤>┘....................................
..............................................................................................................┌┘│...└┬┼─┼┐└┐┌┘>┐│┌┘│>┤├┤│├┬┐....................└┤......................................
..............................................................................................................└┐└┬┐.┌┴┤.│└┐│└─┐├┼┤.└┐├┼┤├┼┼┴┐................┌───┤......................................
...........................................................................................┌─┐.......┌────┬┬┐..└┬┼┼┬┴┐└┬┘.└┘..├┤├┼┬┬┴┼┼┼┼┼┼┐│................└─┐┌┤......................................
..........................................................................................┌┘v└┐...┌──┘....├┤└──┬┴┘││.└┬┘......└┼┼┴┤│.^├┼┴┴┼┤└─┐┌<............┌─┴┘│......................................
..........................................................................................│┌┘┌┘...└┐......└┼┬─┬┘┌<││┌─┼┐.......├┴┐│├──┤│┌┐││.┌┴┼┐..v.v......┌┘┌──┤......................................
..........................................................................................└┤┌┘.┌──┐│.......└┘.└┐├─┘└┘┌┤├┬┐....┌┴┬┼┴┼──┼┼┘│││.└─┘└─┐├┬┼┐..┌┬┬┴┬┼┬┬┼─┬─┐...┌┐.............................
..........................................................................................┌┘└┐.│..└┘...........│└─┬┬┐├┴┴┼┤...┌┼┬┴┤.└┐┌┘└─┼┴┴─┐...┌┴┼┼┼┼┬─┘├┼┐├┼┼┼┴┬┼┐│...├┘.............................
........................................................................................┌─┘..│┌┘...............│..│├┴┼┬┐│├┬┐┌┤│├┬┘.┌┘└─┐.│..┌┘...└┬┼┼┼┼┤..├┴┤└┼┼┴─┼┘││.┌┐├┐.............................
......................................................................................┌─┘....└┘................│..│├┬┤└┴┼┼┤└┼┼┴┤├──┘...│.│..│vv.v┌┴┼┼┼┼┼┬┐└┐│┌┼┴┐┌┼┬┘│┌┘└┼┘.............................
......................................................................................└┐.....................┌─┘┌┐└┤├┴┬┬┴┴┴┐│├─┤└┬─┐..┌┼┬┼┐┌┼┤├┐├┼┬┼┼┼┼┼┤^┌┘├┼┼┬┼┼┼┼┬┼┘..└──┐...........................
......................................................................................┌┘.....................└──┼┼┐││.└┘...├┤├┬┤┌┘.└┐v└┴┴┴┤│├┼┼┼┼┼┼┼┼┼┼┼┼─┘.└┴┼┴┼┴┤├┘├──┐.┌┐└┐..........................
......................................................................................│........................┌┘│└┼┘....┌─┼┼┼┴┴┴┐..├┼┐...└┼┼┼┼┼┼┼┼┼┼┼┼┼┤.....^.└┬┼┤>┘┌─┘v├┴┐│..........................
......................................................................................└┐.....................┌─┘┌┘.└─┐...└─┘├┴┐..^.┌┼┼┼────┴┼┼┼┼┼┼┼┼┼┼┼┼┤.......┌┘├┤┌─┘┌┬┴┘.├┘..........................
.......................................................................................└──┐..................└─┐│....└─┐┌───┘>┘....^├┤│....┌┼┼┼┼┼┼┼┼┤├┼┘│.....┌─┘.└┼┴──┤│...└<..........................
..........................................................................................└──┐....┌──┐.┌┐......│└┐.....└┘..........┌┼┴┘....└┼┼┼┼┼┼┼┼┼┼┼┬┴┐....└──┐>┼┐┌─┘│...............................
.............................................................................................└─┐.┌┘..├┬┴┤......└─┘................>┴┘.......├┼┼┼┼┼┼┼┼┼┼┤┌┼┬┐..┌─┐└─┼┤└──┘...............................
...............................................................................................└┐│┌┬─┤│┌┘..................................┌┼┼┼┼┼┼┼┼┼┼┼┼┴┤├┤┌┐│.└─┬┘│...................................
................................................................................................└┴┘└┬┼┼┘...........................┌<......│├┼┼┼┼┼┼┼┼┼┼┼┬┴┴┼┼┴┼┐┌┐^┌┘..┌┐...............................
....................................................................................................├┴┤............................├┬┐....┌┘├┘││├┼┼┼┼┼┼┼┼┬─┘└┐│└┘└┐└─┐.││...............................
....................................................................................................└─┤............................││^....└─┤.└┼┼┼┼┼┼┼┼┼┼┤┌<.││...├┐v└─┘│...............................
......................................................................................................│................v...........││.......└┐.├┼┼┼┼┼┼┼┼┤└┤..││...│└┘┌──┘...............................
...........................................................................................┌┐.........└┐..............┌┴┐.......┌┬┐││........│.├┴┼┴┼┼┼┼┼┼┬┘..││...│┌─┘..................................
...........................................................................................││..........│┌──┐..........│┌┤┌┐.....├┼┴┴┴┐.......│.└─┘.└┤├┼┼┴┼┐┌─┘│...└┘....................................
..........................................................................................┌┘│..........└┘..│..........││└┘│┌────┼┼─┬<└───┐...│......├┼┼┼┬┼┴┘┌┐│.........................................
..........................................................................................├┐│..┌┐..........│.....┌┐...└┤..└┘...>┤├─┘.v┌──┘...└┐.....└┼┼┼┼┴──┘└┘.........................................
..........................................................................................│││┌┬┤├┐.........│.....│└┐┌┬┬┼───┐...>┴┘...└┴─┐┌┐.┌┐│┌─┐..┌┼┴┤│...............................................
..........................................................................................│└┴┤├┤├┼───┬─┐...│...┌─┼┐└┘├┼┼─┐┌┘...........┌┘││┌┘│└┘┌┘..││.└┘...............................................
..........................................................................................└<┌┴┘└┘│...│┌┘.┌┐│.┌┐└┐└┼┬┬┼┤^.││............└─┘└┘┌┘┌┐│.┌<├┘..................................................
............................................................................................│....└┐..^│┌─┘└┴┬┤└─┘.└┴┼┤│..├┤v................└┐│││.└─┘...................................................
............................................................................................^....┌┤..┌┘└─┐┌┬┼┼┬┬┬┬─┐└┼┼┐.├┘└┐..............┌─┘│└┘.......................................................
...............................................................................................┌─┼┘..└──┐│^├┴┤├┼┼┘.│┌┼┘^.├─┐│...........┌──┘..└┐........................................................
..............................................................................................>┘.├┬┐...┌┘└┐└┬┼┤├┤..└┘└┐..├┐├┘.┌┐.┌┐.....│┌──┐.┌┘........................................................
.................................................................................................││├<..└┐.├┐├┼┼┼┴┬┐...│..├┴┤.┌┘│┌┤│.....└┘..└┐└┐........................................................
.................................................................................................└┤│....└┬┤└┘├┴┤┌┤│..┌┘..│.└─┴┐├┼┼┤..........└─┘........................................................
..................................................................................................└┤.....│├┬┬┴─┼┴┴┴─┬┼┐..└┐...│├┼┼┼┐....................................................................
...................................................................................................│.....└┴┴┘┌─┘....│├┘...└───┴┴┴┼┼┘....................................................................
...................................................................................................└┐.....┌─┐└┐.....^├<.........┌┘└┐....................................................................
...................................................................................................┌┘┌────┘.└─┘......├<.........│>┬┘....................................................................
...................................................................................................└─┘..............┌┤┌┐........└─┘.....................................................................
....................................................................................................................└┴┤├┐...............................................................................
.................................................................................................................v...┌┴┤│...............................................................................
.................................................................................................................│..┌┼─┘^...............................................................................
.................................................................................................................└──┴┘..............